
#키보토스 - Kivotos#
GEH = "countries/GEH.txt"
GEM = "countries/GEH.txt"
MIL = "countries/MIL.txt"
SHA = "countries/SHA.txt"
ABY = "countries/ABY.txt"
ABC = "countries/ABC.txt"
TRM = "countries/TRM.txt"
TRC = "countries/TRM.txt"

RED = "countries/RED.txt"
RE1 = "countries/RED.txt"
RE2 = "countries/RED.txt"
RE3 = "countries/RED.txt"
RE4 = "countries/RED.txt"

HYA = "countries/HYA.txt"
HEU = "countries/HEU.txt"
KSP = "countries/KSP.txt"
SHE = "countries/SHE.txt"
ARI = "countries/ARI.txt"
KAI = "countries/KAI.txt"
GEI = "countries/GEI.txt"
SRT = "countries/SRT.txt"
COU = "countries/COU.txt"
BAC = "countries/BAC.txt"
SUH = "countries/SUH.txt"
INK = "countries/INK.txt"
BLM = "countries/BLM.txt"
#비키보토스 - non-Kivotos#
GEN = "countries/GEN.txt"
GEA = "countries/Germany.txt"
GEF = "countries/Germany.txt"
KPD = "countries/Germany.txt"
NSD = "countries/Germany.txt"
HND = "countries/British Raj.txt"
ZZZ = "countries/TRM.txt" #아나키
MAI = "countries/MAI.txt" #마이소르 번국
MDR = "countries/MDR.txt" #트라방코르 번국
HDR = "countries/HDR.txt" #하이데바라드 번국
RJP = "countries/RJP.txt" #라지푸티나 번국
BAR = "countries/BAR.txt" #바로다 번국
BAL = "countries/BAL.txt" #발루치스탄 번국 연합
KAS = "countries/KAS.txt" #잠무 카슈미르 번국
GAL = "countries/GAL.txt" #갈리치아
FRM	= "countries/France.txt" #마지노선 프랑스 주둔군
STY = "countries/STY.txt"
VTI = "countries/VTI.txt"
MRB = "countries/MRB.txt"
IST = "countries/IST.txt"
ZAG = "countries/ZAG.txt"
DBR = "countries/DBR.txt"
BUD = "countries/BUD.txt"
BTL = "countries/BTL.txt"

CSB = "countries/CSA.txt" #미국 내전용
USP = "countries/USA.txt" #미국용

#테스트 국가 - Test-country#
TGH = "countries/GEH.txt"

#판도용 국가#
TRU = "countries/Soviet Union.txt"
TRE = "countries/Soviet Union.txt"
# 우마무슨메
UMA = "countries/Japan.txt"


KBT = "countries/SHE.txt"
KAP = "countries/ComChina.txt"